21,21,21,21,21,21,21,21,21,21,21,21,21,21,21,21,21,21,21,21,21,21,21,21,21
21,21,21,21,21,21,21,21,21,21,21,17,13,13,13,13,13,13,13,13,13,13,18,21,21
21,21,21,21,21,21,21,21,21,21,21,11,00,00,00,00,00,00,00,00,00,00,14,18,21
21,21,21,21,21,21,21,21,21,21,21,11,00,00,00,00,00,00,00,00,00,00,00,22,21
21,21,21,21,21,21,21,21,21,21,21,11,00,00,00,00,00,00,00,00,00,00,00,22,21
21,21,21,21,21,21,17,13,13,13,13,12,00,00,00,00,00,00,00,00,00,00,00,22,21
21,21,21,21,21,21,11,00,00,00,00,00,00,00,00,21,21,00,00,00,00,00,00,22,21
21,17,13,13,13,13,12,00,15,09,10,00,00,00,00,21,21,00,00,00,00,00,00,22,21
21,11,15,09,09,09,09,10,22,21,11,00,00,00,00,21,21,00,00,00,00,00,00,22,21
21,11,22,21,21,21,21,11,14,13,12,00,00,00,00,21,21,00,00,00,00,00,00,22,21
21,11,22,21,21,21,21,11,00,00,00,00,00,00,00,21,21,00,00,00,00,00,00,22,21
21,11,22,21,21,21,21,16,10,00,00,00,00,00,00,00,00,00,00,00,00,00,00,22,21
21,11,22,21,21,21,21,21,21,00,00,00,00,00,00,00,00,00,00,00,00,00,00,22,21
21,11,22,21,21,21,21,21,21,16,09,09,09,09,09,09,10,15,09,09,10,00,00,14,18
17,12,14,13,18,21,21,21,21,21,21,21,21,21,21,21,16,19,21,21,16,09,09,09,19
11,00,00,00,22,21,21,21,21,21,21,21,21,21,21,21,21,21,21,21,21,21,21,21,21
11,00,00,00,22,21,21,21,21,21,21,21,21,21,21,21,21,21,21,21,21,21,21,21,21
11,00,00,00,22,21,21,21,21,21,21,21,21,21,21,21,21,21,21,21,21,21,21,21,21
16,09,09,09,19,21,21,21,21,21,21,21,21,21,21,21,21,21,21,21,21,21,21,21,21
21,21,21,21,21,21,21,21,21,21,21,21,21,21,21,21,21,21,21,21,21,21,21,21,21

00,00,00,00,00,00,00,00,00,00,00,00,00,00,00,00,00,00,00,00,00,00,00,00,00
00,00,00,00,00,00,00,00,00,00,00,00,00,00,00,00,00,00,00,00,00,00,00,00,00
00,00,00,00,00,00,00,00,00,00,00,00,00,00,00,00,00,00,00,00,00,00,00,00,00
00,00,00,00,00,00,00,00,00,00,00,00,00,00,00,00,00,00,00,00,00,00,00,00,00
00,00,00,00,00,00,00,00,00,00,00,00,00,00,00,00,00,00,00,00,00,00,00,00,00
00,00,00,00,00,00,00,00,00,00,00,00,00,00,00,00,00,00,00,00,00,00,00,00,00
00,00,00,00,00,00,00,00,00,00,00,00,00,00,00,00,00,00,00,00,00,00,00,00,00
00,00,00,00,00,00,00,00,00,00,00,00,00,00,00,00,00,00,00,00,00,00,00,00,00
00,00,00,00,00,00,00,00,00,00,00,00,00,00,00,00,00,00,00,00,00,00,00,00,00
00,00,00,00,00,00,00,00,00,00,00,00,00,00,00,00,00,00,00,00,00,00,00,00,00
00,00,00,00,00,00,00,00,00,00,00,00,00,00,00,00,00,00,00,00,00,00,00,00,00
00,00,00,00,00,00,00,00,00,00,00,00,00,00,00,00,00,00,00,00,00,00,00,00,00
00,00,00,00,00,00,00,00,00,00,00,00,00,00,00,00,00,00,00,00,00,00,00,00,00
00,00,00,00,00,00,00,00,00,00,00,00,00,00,00,00,00,00,00,00,00,00,00,00,00
00,00,00,00,00,00,00,00,00,00,00,00,00,00,00,00,00,00,00,00,00,00,00,00,00
01,01,01,01,00,00,00,00,00,00,00,00,00,00,00,00,00,00,00,00,00,00,00,00,00
00,00,00,01,00,00,00,00,00,00,00,00,00,00,00,00,00,00,00,00,00,00,00,00,00
00,00,00,01,00,00,00,00,00,00,00,00,00,00,00,00,00,00,00,00,00,00,00,00,00
00,00,00,01,00,00,00,00,00,00,00,00,00,00,00,00,00,00,00,00,00,00,00,00,00
01,01,01,01,00,00,00,00,00,00,00,00,00,00,00,00,00,00,00,00,00,00,00,00,00